xxxxxxxxxxxxxxxxxxxxxxxxxx
00001000000001100000110101
00001000000010000000000011
00001000000011110000011100
00010000000011000000011100
00111100000001110000110111
00111100000100100000110011
01000100000000010000000110
01010000000010010000111000
01100000000100000000101001
01110000000100010000010000
01111100000100110000010011
10000100000011010000100101
10001100000010100000111011
10010000000000100000110010
10010100000011100000101010
10101000000010110000111011
10101100000001000000100101
11001000000001010000010001
11110100000101000000001001
