000000000101000100000000010000000110
000000000010010000000000100000110010
000000000011111000000000110000001111
000000000010101100000001000000100101
000000000011001000000001010000010001
000000000000001000000001100000110101
000000000100111100000001110000110111
000000000100001000000010000000000011
000000000001010000000010010000111000
000000000010001100000010100000111011
000000000010101000000010110000111011
000000000000010000000011000000011100
000000000010000100000011010000100101
000000000010010100000011100000101010
000000000000001000000011110000011100
000000000001100000000100000000101001
000000000001110000000100010000010000
000000000100111100000100100000110011
000000000001111100000100110000010011
000000000011110100000101000000001001
000000000000011000000101010000110111
000000000000000100000101100000011000
000000000010110000000101110000111111
000000000101111000000110000000000110
000000000011011100000110010000101010
000000000110001000000110100000000011
000000000100111000000110110000111101
000000000100001100000111000000110100
000000000010001100000111010000010011
000000000010010000000111100000001100
000000000011101100000111110000001111
000000000010101000001000000000101001
000000000010110000001000010000101001
000000000011000000001000100000101000
000000000000111000001000110000010000
000000000010100000001001000000111010
000000000100111000001001010000100110
000000000010011100001001100000110001
000000000001010000001001110000100000
000000000100010000001010000000011000
000000000101011000001010010000001101
000000000000001000001010100000001001
000000000101100000001010110000000010
000000000011110000001011000000011000
000000000001000100001011010000111010
000000000011000100001011100000010001
000000000000010000001011110000001110
000000000100101100001100000000011000
000000000010001100001100010000110011
000000000000110000001100100000001101
000000000011100100001100110000001100
000000000011110100001101000000100101
000000000001001000001101010000010110
000000000001110100001101100000111100
000000000110000000001101110000101101
000000000001101100001110000000010011
000000000101100100001110010000000101
000000000001101000001110100000011111
000000000010000100001110110000100010
000000000000100100001111000000000110
000000000001011000001111010000101010
000000000011101100001111100000101011
000000000010100000001111110000011000
